2 4 14 12 12 12 12 12 10 
5 10 5 14 8 6 12 12 11 
2 5 10 1 6 9 2 6 9 
7 8 5 12 9 6 11 3 2 
7 12 12 14 12 9 1 5 11 
5 14 8 3 6 10 6 12 9 
2 3 6 9 3 5 9 6 10 
3 3 5 12 9 4 14 9 3 
5 13 12 12 12 12 9 4 9 
