2 4 14 8 6 14 12 12 8 
5 10 7 12 9 5 12 12 10 
6 9 5 12 10 4 14 8 3 
5 10 6 10 3 6 11 6 9 
6 9 7 9 5 9 3 5 10 
3 4 13 14 8 6 13 8 3 
5 12 10 7 12 13 8 6 11 
2 6 9 1 6 12 10 3 3 
5 13 12 12 9 4 13 9 1 
