4 12 10 6 12 14 14 14 8 
6 12 15 13 8 1 1 5 10 
5 8 7 14 12 12 14 8 3 
6 12 11 1 6 10 5 8 1 
1 4 15 12 15 9 6 12 8 
4 12 9 2 7 12 13 12 10 
6 8 2 7 15 10 6 8 1 
5 14 13 11 3 7 11 4 10 
4 13 8 1 1 1 5 12 9 
